ステージ１
テスト用コース\n

0,-1,0
0

0,0,0,0,0,0,0,0,0,0,0,0,0,0,0,0,0,0,0,0
0,0,0,0,0,0,0,0,0,0,0,0,2,0,0,0,0,0,0,0
0,0,0,0,0,0,0,0,0,0,0,2,2,2,0,0,0,0,0,0
0,0,0,2,0,0,0,0,0,0,0,0,0,0,0,2,0,0,0,0
0,0,0,2,0,2,0,0,0,0,0,0,0,0,2,2,0,0,0,0
2,2,2,2,2,2,2,2,2,0,0,0,0,0,0,2,0,0,0,0
0,0,0,2,0,0,0,2,0,0,2,0,0,0,0,0,0,0,0,0
0,0,0,2,0,0,0,0,0,0,2,2,0,0,2,2,2,0,0,0
0,0,0,0,0,0,0,0,0,0,2,0,0,0,0,2,0,0,0,0
0,0,0,0,0,0,0,0,0,0,0,0,0,0,0,0,0,0,0,0

8,2,1,0
8,8,0,0
