チュートリアル１
基本操作解説

0,-1,0
0,1

3,3,3,3,3,3,3,3,3,3,3,3,3,3,3,3,3,3,3,3
3,3,3,3,3,3,3,0,0,0,3,3,3,3,3,3,3,3,3,3
3,3,3,3,3,3,0,0,0,0,0,3,3,3,3,3,3,3,3,3
3,3,3,3,3,3,0,0,0,0,0,3,3,3,3,3,3,3,3,3
3,3,3,3,3,3,0,0,0,0,0,3,3,3,3,3,3,3,3,3
3,3,3,3,3,3,0,0,0,0,0,3,3,3,3,3,3,3,3,3
3,3,3,3,3,3,0,0,0,0,0,3,3,3,3,3,3,3,3,3
3,3,3,3,3,3,0,0,0,0,0,3,3,3,3,3,3,3,3,3
3,3,3,3,3,3,3,0,0,0,3,3,3,3,3,3,3,3,3,3
3,3,3,3,3,3,3,3,3,3,3,3,3,3,3,3,3,3,3,3

8,2,0,1
8,7,0,0
