‰Í”È
NONE

0,-1,3
12

3,3,0,0,0,0,0,0,0,0,0,0,0,0,0,0,0,0,3,3
3,0,0,0,0,0,0,0,0,4,0,0,0,0,0,0,0,0,0,3
3,0,0,0,0,0,0,0,0,0,0,0,0,0,0,0,0,0,1,1
3,3,0,0,0,0,0,0,0,0,0,0,0,0,0,0,0,0,0,3
2,2,2,2,2,2,2,2,2,2,0,0,0,1,1,0,0,0,3,3
3,0,0,0,1,1,0,0,0,2,2,2,2,2,2,2,2,2,2,2
3,3,0,0,0,0,0,0,0,0,0,0,0,0,0,0,0,0,0,3
3,0,0,0,0,0,0,0,0,0,0,0,0,0,0,0,0,0,0,3
3,0,0,0,0,0,0,0,0,5,0,0,0,0,0,0,0,0,0,3
3,3,0,0,0,0,0,0,0,0,0,0,0,0,0,0,0,0,3,3

6,1,-1,0
7,1,-1,0
8,1,-1,0
9,1,-1,0
10,1,-1,0
11,1,-1,0
12,1,-1,0
6,2,-1,0
7,2,-1,0
8,2,-1,0
9,2,-1,0
10,2,-1,0
11,2,-1,0
12,2,-1,0
